11111111111111111111111111
1EC00000000010000000010001
10000000000010000P00010001
10000000000010000000010001
10000000000010000000010001
10000000000011111111110001
10000000000000000000000001
10000000C00000000000000001
10000000000000000000000001
11111111111111111111111111