111111111111111111111111111
1ECP00000000000000000000001
100000000000000000000000001
100000000000000000000000001
10000000000000000000C000001
100000000000000000000000001
10000000C000000000000000001
100000000000000000000000001
100000000000000000000000001
111111111111111111111111111