111111111111111
10000000000P111
111111111111111
100000CE1111111
111111111111111