1111111111
10P0000001
10001c1111
1111100001
1000001111
1E110000C1
1111111111